NO img/doom_3.xpm
SO img/doom_3.xpm
WE img/doom_5.xpm
EA img/doom_6.xpm

F 227,126,122
C 0,255,255

1111111111111111111111111
1000000000110000000000001
1011000001110000000000001
1001000000000000000000001
111111111011000001110000111111111
100000000011000001110111111111111
11110111111111011100000010001
11110111111111011101010010001
11000000110101011100000010001
10000000000000001100000010001
10000000000000001101010010001
11000001110101011111011110N1111
11110111111010111011110100011
11111111111111111111111111111